0 0 0 0 0 0 0 0 0 0 0 0 0 0 0 
0 0 0 0 0 0 0 0 0 0 0 0 252 253 0
0 0 0 0 0 0 0 0 0 0 0 0 254 255 0
0 0 0 0 0 0 0 0 0 0 0 0 0 0 0
5 0 0 0 0 0 0 0 0 0 0 0 0 0 0
1 5 0 0 0 0 0 0 0 0 0 0 0 0 0
1 1 5 0 0 0 0 0 0 0 0 4 5 0 0
1 1 1 5 0 0 0 0 0 0 4 1 1 5 0
1 1 1 1 0 0 0 0 0 0 3 1 1 2 0
1 1 1 1 0 0 0 0 0 0 0 3 2 0 0
1 1 1 2 0 1 0 0 1 0 1 0 0 0 0
1 1 2 0 0 1 0 1 0 1 1 0 0 0 0
1 2 0 0 0 1 1 0 1 0 1 1 0 0 0
2 0 0 0 0 0 0 0 0 0 0 0 0 0 0
0 0 0 0 0 4 5 0 0 0 0 0 0 0 0
0 0 0 0 4 1 1 5 0 0 0 0 0 0 0
0 0 0 0 3 1 1 2 0 0 0 0 0 0 0
0 0 0 0 0 3 2 0 0 0 0 0 0 0 0
0 0 0 0 0 0 0 0 0 0 0 0 0 0 0
0 0 0 0 0 0 0 0 0 0 0 0 0 0 0